G G G G G G G G W W W W W W G G G G G G G G G G G G G G W W W W W W G G G G G G 
 G G G G G G G W W W W W W G G G G G G G G G G G G G G G W W W W W W G G G G G G 
 G G G G G G G W W W W W W W W W G G G G G G G G G G G G W W W W W W G G G G G G 
 G G G G G W W W W W W W W W W W G G G G G G G G G G G G W W W W W W G G G G G G 
 G G G G G G W W W W W G G W W W W G G G G G G G G G G G W W W W W W G G G G G G 
 G G G G W W W W W W S G G G G G G G G G G G G G G G G G W W W W W W G G G G G G 
 G G G G W W W W G S S G G G G G G G G G G G G G G G G G W W W W W W G G G G G G 
 G W W W W W W W G S S G G G G D G G G G G G G G G G G G W W W W W W G G G G G G 
 G G G W W W W G G S S G G G D D D G G G G G G G G G G G W W W W W W G G G G G G 
 G G G W G G G G G S S G G D D D D D G G G G G G G G G G W W W W W W G G G G G G 
 G G G W G G G G G S S G G G D D G G G G G G G G G G G G W W W W W W G G G G G G 
 G G G W G G G G G S S G G G G G G G G G G G G G G G G G W W W W W W G G G G G G 
 G G G W G G G G S S S S G G G G G G G G G G G G G G G G W W W W W W G G G G G G 
 G G G W G G G S S S S S S G G G G G G G G G G G G G G G W W W W W W G G G G G G 
 S S S S S S S S S D D S S S S S S S S S S S S S S S S S S S S S S S S S S S S S 
 S S S S S S S S S D D S S S S S S S S S S S S S S S S S S S S S S S S S S S S S 
 G G G W G G G S S S S S S G G G G G G G G G G G G G G G W W S S W W G G G G G G 
 G G G W G G G G S S S S G G G G G G G G G G G G G G G G W W S S W W G G G G G G 
 G G G W G G G G G S S G G G G G G G G G G G G G G G G G W W S S W W G G G G G G 
 G G G W G G G G G S S G G G G G G G G G G G G G G G G G W W S S W W G G G G G G 
 G G G G G G G G G S S G G G G G G G G G G G G G G G G G W W S S W W G G G G G G 
 G G G G G G G W W S S W W G G G G G G G G G G G G G G G W W S S W W G G G G G G 
 G G G G G G G W W S S W W W W W G G G G G G G G G G G G W W S S W W G G G G G G 
 G G G G G W W W W S S W W W W W G G G G G G G G G G G G W W S S W W G G G G G G 
 G G G G G G W W W S S G G W W W W G G G G G G G G G G G W W S S W W G G G G G G 
 G G G G W W W W W S S G G G G G G G G G G G G G G G G G W W S S W W G G G G G G 
 G G G G W W W W G S S G G G G G G G G G G G G G G G G G W W S S W W G G G G G G 
 G W W W W W W W G S S G G G G D G G G G G G G G G G G G W W S S W W G G G G G G 
 G G G W W W W G G S S G G G D D D G G G G G G G G G G G W W S S W W G G G G G G 
 G G G W G G G G G S S G G D D D D D G G G G G G G G G G W W S S W W G G G G G G 
 G G G W G G G G G S S G G G D D G G G G G G G G G G G G W W S S W W G G G G G G 
 G G G W G G G G G S S G G G G G G G G G G G G G G G G G W W S S W W G G G G G G 
 G G G W G G G G S S S S G G G G G G G G G G G G G G G G W W S S W W G G G G G G 
 G G G W G G G S S S S S S G G G G G G G G G G G G G G G W W S S W W G G G G G G 
 S S S S S S S S S S S S S S S S S S S S S S S S S S S S S S S S S S S S S S S S 
 S S S S S S S S S S S S S S S S S S S S S S S S S S S S S S S S S S S S S S S S 
 G G G W G G G S S S S S S G G G G G G G G G G G G G G G W W W W W W G G G G G G 
 G G G W G G G G S S S S G G G G G G G G G G G G G G G G W W W W W W G G G G G G 
 G G G W G G G G G S S G G G G G G G G G G G G G G G G G W W W W W W G G G G G G 
 G G G W G G G G G S S G G G G G G G G G G G G G G G G G W W W W W W G G G G G G 
 G G G G G G G G W W W W W W G G G G G G G G G G G G G G W W W W W W G G G G G G 
 G G G G G G G W W W W W W G G G G G G G G G G G G G G G W W W W W W G G G G G G 
 G G G G G G G W W W W W W W W W G G G G G G G G G G G G W W W W W W G G G G G G 
 G G G G G W W W W W W W W W W W G G G G G G G G G G G G W W W W W W G G G G G G 
 G G G G G G W W W W W G G W W W W G G G G G G G G G G G W W W W W W G G G G G G 
 G G G G W W W W W W S G G G G G G G G G G G G G G G G G W W W W W W G G G G G G 
 G G G G W W W W G S S G G G G G G G G G G G G G G G G G W W W W W W G G G G G G 
 G W W W W W W W G S S G G G G D G G G G G G G G G G G G W W W W W W G G G G G G 
 G G G W W W W G G S S G G G D D D G G G G G G G G G G G W W W W W W G G G G G G 
 G G G W G G G G G S S G G D D D D D G G G G G G G G G G W W W W W W G G G G G G 
 G G G W G G G G G S S G G G D D G G G G G G G G G G G G W W W W W W G G G G G G 
 G G G W G G G G G S S G G G G G G G G G G G G G G G G G W W W W W W G G G G G G 
 G G G W G G G G S S S S G G G G G G G G G G G G G G G G W W W W W W G G G G G G 
 G G G W G G G S S S S S S G G G G G G G G G G G G G G G W W W W W W G G G G G G 
 S S S S S S S S S W W S S S S S S S S S S S S S S S S S S S S S S S S S S S S S 
 S S S S S S S S S W W S S S S S S S S S S S S S S S S S S S S S S S S S S S S S 
 G G G W G G G S S S S S S G G G G G G G G G G G G G G G W W S S W W G G G G G G 
 G G G W G G G G S S S S G G G G G G G G G G G G G G G G W W S S W W G G G G G G 
 G G G W G G G G G S S G G G G G G G G G G G G G G G G G W W S S W W G G G G G G 
 G G G W G G G G G S S G G G G G G G D D D D D G G G G G W W S S W W G G G G G G 
 G G G G G G G G G S S G G G G G G G G G G G G G G G G G W W S S W W G G G G G G 
 G G G G G G G W W S S W W G G G G G G G G G G G G G G G W W S S W W G G G G G G 
 G G G G G G G W W S S W W W W W G G G G G G G G G G G G W W S S W W G G G G G G 
 G G G G G W W W W S S W W W W W G G G G G G G G G G G G W W S S W W G G G G G G 
 G G G G G G W W W S S G G W W W W G G G G G G G G G G G W W S S W W G G G G G G 
 G G G G W W W W W S S G G G G G G G G G G G G G G G G G W W S S W W G G G G G G 
 G G G G W W W W G S S G G G G G G G G G G G G G G G G G W W S S W W G G G G G G 
 G W W W W W W W G S S G G G G D G G G G G G G G G G G G W W S S W W G G G G G G 
 G G G W W W W G G S S G G G D D D G G G G G G G G G G G W W S S W W G G G G G G 
 G G G W G G G G G S S G G D D D D D G G G G G G G G G G W W S S W W G G G G G G 
 G G G W G G G G G S S G G G D D G G G G G G G G G G G G W W S S W W G G G G G G 
 G G G W G G G G G S S G G G G G G G G G G G G G G G G G W W S S W W G G G G G G 
 G G G W G G G G S S S S G G G G G G G G G G G G G G G G W W S S W W G G G G G G 
 G G G W G G G S S S S S S G G G G G G G G G G G G G G G W W S S W W G G G G G G 
 S S S S S S S S S S S S S S S S S S S S S S S S S S S S S S S S S S S S S S S S 
 S S S S S S S S S S S S S S S S S S S S S S S S S S S S S S S S S S S S S S S S 
 G G G W G G G S S S S S S G G G G G G G G G G G G G G G W W W W W W G G G G G G 
 G G G W G G G G S S S S G G G G G G G G G G G G G G G G W W W W W W G G G G G G 
 G G G W G G G G G S S G G G G G G G G G G G G G G G G G W W W W W W G G G G G G 
 G G G W G G G G G S S G G G G G G G G G G G G G G G G G W W W W W W G G G G G G 
 